63 175 287 592 393 441 
210 456 486 355 237 272 229 73 
281 307 442 340 575 344 249 31 
177 298 396 720 616 304 22 34 
123 176 321 568 735 456 227 
249 498 855 969 648 83 87 130 126 
233 440 785 936 800 226 193 172 162 
251 272 586 149 332 527 476 544 414 140 
139 358 676 1074 960 747 361 
4 189 409 775 1013 729 595 364 67 
88 147 289 382 792 714 687 925 214 
236 414 815 1279 832 453 122 119 92 193 
173 288 638 1195 776 641 404 
296 256 385 814 780 703 626 439 730 225 209 207 
224 289 706 845 611 846 390 408 129 
107 365 713 1069 1358 918 884 
252 299 643 742 713 780 974 704 289 
127 325 523 966 806 1300 867 207 
135 301 519 1042 1102 936 546 228 
244 358 696 715 778 736 455 337 341 342 
299 231 381 579 632 540 823 543 584 240 
105 243 506 609 981 1388 1237 272 550 
174 350 603 769 1091 895 226 393 144 178 
170 382 763 1149 1694 1541 740 424 70 
239 359 470 611 467 576 753 620 230 134 
192 265 521 660 1030 1084 425 390 314 436 99 
177 373 612 1031 815 1116 835 398 441 167 83 
6 15 41 70 94 146 156 60 20 
3 29 34 52 71 95 97 83 54 45 16 
261 403 786 1074 983 868 1262 454 
1 7 12 38 51 83 94 142 59 32 9 12 
10 24 42 86 112 132 95 53 33 
4 6 22 28 54 102 80 83 74 57 42 15 15 
19 45 51 95 119 162 125 37 
6 19 44 85 75 113 76 51 43 
9 44 275 450 829 966 809 896 574 558 185 371 
12 22 48 98 100 145 130 68 44 17 
1 18 34 66 70 128 126 133 82 50 
11 38 64 76 90 69 90 129 82 45 22 
9 16 30 69 103 145 122 140 62 8 
5 8 37 61 84 87 151 151 99 18 38 20 
6 12 27 53 92 69 85 96 107 64 61 21 
61 253 465 878 1805 1510 1091 968 681 
4 28 53 93 112 145 51 57 84 61 11 
29 33 21 45 86 143 141 149 52 33 27 
20 34 76 145 210 171 82 60 34 9 10 
18 46 33 67 138 140 209 97 51 11 9 9 
29 54 41 75 105 128 127 98 94 68 34 
82 207 445 680 1229 1299 951 305 169 163 
26 37 23 46 72 67 86 103 123 57 17 
194 364 644 1046 1281 1058 388 114 
136 207 557 915 811 882 717 696 
3 26 49 86 127 56 40 49 27 55 26 
9 19 33 43 78 98 76 27 
276 539 1074 686 623 894 817 843 301 317 
27 45 84 73 71 102 40 34 33 
45 280 533 615 1153 1160 794 495 222 
14 22 45 97 129 134 73 24 21 24 
225 319 358 739 587 840 756 31 
147 315 590 1178 1026 985 453 272 
6 23 37 79 83 92 66 23 
24 35 72 116 108 72 81 17 17 
11 23 46 87 88 68 86 100 113 37 37 22 
16 24 53 106 169 79 47 41 28 19 
19 43 67 25 58 50 75 43 26 22 3 3 5 9 
243 377 859 1008 1004 1129 1063 235 104 100 91 
211 448 869 1180 1251 1534 1198 447 140 112 
23 43 84 140 230 162 86 31 27 
262 489 991 1017 853 1191 780 703 260 254 302 170 
144 381 723 1087 1002 969 1240 769 155 
24 46 83 138 167 117 71 80 71 20 11 
10 22 56 97 126 119 64 47 
98 253 511 1065 1572 1663 1292 547 168 
5 10 30 52 71 111 109 54 
191 326 595 659 589 751 472 488 397 134 
22 33 65 136 149 84 49 39 19 18 
7 14 41 54 82 88 100 71 41 17 33 
118 236 521 1085 1232 1906 801 504 286 79 
5 30 41 85 50 59 80 116 122 74 50 24 25 
20 41 71 121 121 141 95 31 26 
95 375 325 477 925 895 324 461 740 607 354 169 
115 228 418 805 1076 1187 1160 955 1074 277 
25 34 47 92 133 93 102 93 56 44 20 
158 300 620 890 1453 1134 844 488 
22 35 71 121 139 120 74 25 
23 41 76 107 135 164 113 31 42 
258 399 795 734 642 806 967 1205 864 143 
233 292 735 1072 1178 563 453 631 702 267 146 
12 23 43 86 128 192 126 57 32 14 14 
15 33 56 92 113 117 101 60 9 
167 374 752 1279 2372 2543 1004 133 10 
22 31 73 114 141 123 135 79 96 39 37 
289 522 685 1042 1199 1163 1262 1032 540 106 186 117 
3 20 39 78 129 192 94 51 24 27 
9 24 44 84 136 160 72 48 
1 15 32 66 130 180 146 150 105 51 19 
181 421 362 847 915 1379 947 742 658 367 
146 267 541 1110 1723 2241 2620 1749 805 
110 143 497 903 1119 1135 1043 1328 767 477 
292 345 459 662 690 1179 1683 533 65 
